11111111
1A0C0P01
10011001
100E0C01
11111111